thread - 線
elastic - 有彈性
puckering - 起皺紋
measure - 測量
pleats - 褶
layer - 層
stripe - 條紋
chambray - 條紋布
bending - 彎曲
bias - 斜的
weft - 緯線
stretch - 伸展
symmetric - 對稱的
unfold - 展開
purl - 流蘇
zigzag - 鋸齒
journal - 雜誌、日記
ombre - 有深淺不同色度
solid - 實心
embed - 嵌入
schematic - 圖解
particle - 粒子
intensity - 強度
desaturatic - 去色的、減淡的
shirring - 使布料形成皺褶
toggle - 切換
cross grain - 直布紋
straddle - 跨
expectation - 期望
workflow - 工作流程
convention - 慣例
construstion - 構造、建造
supplier - 供應者
submit - 提交
approval - 認可
proto - 原型
render - 渲染
preset - 預設
content - 內容
garment - 服裝
component - 成分
virtual - 虛擬的
arrange - 安排
asset - 資產
garphic - 圖形
label - 標籤
usage - 用法
chart - 圖表
comparison - 比較
template - 模板
bulk - 大部分
access - 存取
annotation - 註解
appendix - 附錄
outline - 概述
standardize - 標準化
workable - 落實、可行的
function - 功能
visual - 視覺的
continuity - 連續性
variable - 變數
acceptable - 可接受的
alignment - 核准
category - 類別
efficiency - 效率
duplicative - 重複的
misunderstanding - 誤解
shrinkage - 收縮
grainline - 紋路
accurate - 準確的
convert - 轉變
determined - 決定
grade - 等差
loss - 損耗
scale - 比例
applicable - 適用的
approved - 被正式認可
prototype - 樣板
numeric - 數字
character - 文字
prevent - 防止
storage - 儲存
description - 描述
specify - 指定
instruction - 說明
simulated - 模擬的
vendors - 供應商
reference - 參考
brand - 品牌
permission - 允許
demonstrate - 示範
merch - 商品
allover - 滿版
spec - 規定、尺寸
property - 性質
emulate - 仿真
swatch - 色板
texture - 質地
mimic - 類似
exact - 準確
substitute - 代替
capable - 有能力的
unified - 統一
format - 格式
aim - 目的
application - 應用程式
consistent - 持續的
manner - 方式
assign - 指定
preserve - 保存
discretion - 慎重
method - 方法
adjust - 調整
crop - 修剪
result - 導致
manual - 手工的
proper - 恰當的
intend - 意圖
enhance - 增加
drape - 垂墜
vector - 向量
placket - 門襟
inseam - 內脇
indentation - 縮進
decorative - 裝飾性的
appropriate - 合適的
functional - 功能性的、實用
via - 經由
anchor - 錨
utilize - 利用
enable - 能夠
grommet - 扣眼
assort - 配合
dimension - 尺寸
metric - 公制
caliper - 卡尺
individual - 個別
sprarate - 分離
manipulate - 操縱
fill out - 填寫
structure - 結構
brief - 簡短的
buckle - 扣子
imitate - 模擬
imperative - 重要的
remodel - 改造
associate - 聯繫
evaluated - 評估
analyze - 分析
criteria - 標準
crease - 褶痕
reveal - 現示
perpendicular - 垂直
paralled - 平行
specifically - 特別來說
alter - 改變
lightly - 輕易
imbalance - 不平衡
improper - 不合適
excess - 過多的
workmanship - 做工
familiarity - 熟悉度
adhere - 堅持
yoke - 抵肩
significent - 重要
in addition - 此外
adjacent - 鄰近的
dictate - 聽寫
alignment - 對準
wrinkle - 皺紋
strap - 帶子
uneven - 不均勻的
flimsy - 脆弱的
specification - 規格
indication - 標
intermediate - 中間的
layout - 排列
neatly - 整齊地
interior - 內部的
gauge - 標準尺寸
margin - 內縮
thickness - 厚度
folded - 折疊
existing - 現存的
appearance - 外表
turtleneck - 高領毛衣
ruffle - 荷葉邊
general - 一般的
vary - 各不相同
cutout - 切斷
scalloped - 扇形
picot - 花邊上小環
turntable - 轉盤
rotate - 旋轉
multiplier - 增加
overlap - 重疊
permit - 允許
attach - 連接
assignment - 任務
comparable - 可比
garage - 車庫
actual - 實際的
molded - 成型的
grid - 格
transparent - 透明的
underneath - 在...之下
from scratch - 從零開始
desire - 要
encase - 包住
row - 排
gather - 聚集
faux - 人工的
tube - 管
knuckle - 關節
ply - 鋪層
gusset - 扣板
puffy - 腫大的
insulation - 絕緣
overall - 全面的
firmness - 硬度
padding - 填充
primary - 主要的
monument - 紀念碑
therefore - 所以
closure - 關閉
fur - 毛皮
accessory - 配飾
instill - 灌輸
compile - 編輯
certify - 證明
relevant - 相關的
mention - 提到
allocate - 分配
ongoing - 經常得
validation - 驗證
verify - 核實
finalized - 完成
discuss - 討論
