военная (Voyennaya) - 軍隊 

операция (operatsiya) - Operation

Украине (Ukraine) - 烏克蘭

русская (russkaya) - 俄羅斯 俄語

Подписывайтесь (Podpisyvaytes' ) - 訂閱

служба (sluzhba) - 服務

на (na) - 在 on, to, at, in, for

Страсть (strast') -  熱情

курению (kureniyu) - 抽煙

хочу (khochu) - want, will

пожелать (pozhelat’) - wish

вам (vam) - to you

всем (vsem) - 大家

с (s) - with

новым (novym) - 新

годом (godom) - 年

фото (foto) - 照片

видео (video) - 影片

Россияне (Rossiyane) - 俄羅斯人

устали (ustali) - 厭倦

от (ot) - from

Путина (Putina) - Putin

Россия (Rossiya) - 俄羅斯

Беларусь (Belarus’) - 白俄羅斯

и (i) - and

объединят (ob”yedinyat) - 團結 unite

госпропаганду (gospropapandu) - 國家宣傳 state progaganda

гос (gos) - state

пропаганду (propapandu) - 宣傳

Засуха (zasukha) - 乾旱

в (v) - in, to

Европе (Yevrope) - 歐洲

установила (ustanovila) - 建立 established

рекорд (rekord) - 紀錄 record

со (so) - 

времен (vremen) - 時期 時間 time period

Магеллана (Magellana) - 麥哲倫

начали (nachali) - 開始 started

Москве (Moskve) - 莫斯科 Moscow

лет (let) - 年 歲 years

без (bez) - without

игр (igr) - 遊戲 比賽 games

человек (chelovek) - 人 man people

маньяк (man’yak) - 瘋子 maniac

войну (voynu) - 戰爭 war

января (yanvarya) - 一月 (引valia)

Одежда (Odezhda) - 衣服、布

Зарядки (Zaryadki) - 充電器、收費 charge

Ноутбук (Noutbuk) - 筆電 notebook

Наушники (Naushniki) - 耳機

сижу (sizhu) - 坐著 sitting

смотрю (smotryo) - 看著 watching

чужое (chuzhoye) - 別人的 someone else’s

чужого (chuzhogo) - 別人的 someone else’s

небо (nebo) -  天空 sky

из (iz) - from

окна (okna) - 窗戶 window

и (i) - And

не (ne) - not

вижу (vizhu) - see 看到

одной (odnoy) - one 一

знакомой (znakomoy) - 熟悉的 familiar

звезды (zvezdy) - 星星 star

ходил (khodil) - 走 walked

по (po) - by

всем (vsem) - everyone/all

дорогам (dorogam) - 路 roads

туда (tuda) - 那裡 there

сюда (syuda) - 這裡 here

обернулся (obernulsya) - 回頭 turned around

смог (smog) - 煙霧 smog

разглядеть (razglyadet’) - 辨別

следы (sledy) - track, footprint 

Значит (znachit) - 所以 so, well then

всё (vso 四喔) - 所有 全部 all

так (tak) - so, like this, that

уж (uzh) - already, really

плохо (plokho) - 糟糕地 badly

сегодняшний (segodnyashiniy) - 今日

день (den) - day

на (na) - on, to, at, in